111111
1E0001
111101
11C001
100C01
100001
101101
10C001
1000P1
111111