1111111111111
1C00000000001
1111011C10001
1C11011110101
1000001P00101
1C100000011E1
1111111111111